XXXXXXXXXXXXXXXXXXXX
XCX$GXGGGGG$XGG$XGHX
XGXGGXGXXXXXXGXXXGGX
XGXGGXGXGGGGGGGGXXGX
XGXGGXGXXXXXXXXGGXGX
XGXGGGGXGGGGGGXGXXGX
XGXXXXGXXGX$XGXGXXGX
XGGGGG$GGGXGXGXGX$GX
XXXXGXXXX$XXXGGGXGXX
XGGXGGGGXGGGXGXXXGGX
XG$X$XGGXGX$X$X$XXGX
XGXXXXXGXXXXXXXGXGGX
XGGGGXGGX$XXXGGGXGXX
XGXG$XXGGGGXXGXXXGGX
XGXGGGGGXXXGXGGGGGGX
XGXXXXXXXXXGXGXXXXGX
XGXXGGGGGGG$XGGGGX$X
X$XXGXXXXGGGXXXXGXXX
XGGG$X$GGGGGGGGGGG$X
XXXXXXXXXXXXXXXXXXXX
